#domain
hospital
#levelname
MAPF02
#colors
blue: 0, A
#initial
+++++++++++++
+           +
+        ++++
+           +
+0       ++ +
+        A+ +
+++++++++++++
#goal
+++++++++++++
+          A+
+        ++++
+           +
+        ++ +
+         + +
+++++++++++++
#end
