#domain
hospital
#levelname
MAPF01
#colors
blue: 0,1,2
#initial
+++++++++++++
+          1+
+        ++++
+ 0         +
+        ++ +
+2        + +
+++++++++++++
#goal
+++++++++++++
+1          +
+        ++++
+           +
+        ++ +
+        2+0+
+++++++++++++
#end
