#domain
hospital
#levelname
MAPF03
#colors
blue: 0, B, C
red: 1, A
#initial
+++++++++++++
+           +
+        ++++
+ C      B  +
+ 0     A++ +
+         +1+
+++++++++++++
#goal
+++++++++++++
+A         C+
+        ++++
+           +
+        ++ +
+         + +
+++++++++++++
#end
