#domain
hospital
#levelname
MAPF03
#colors
blue: 0, B
red: A
#initial
+++++++++++++
+           +
+       A++++
+           +
+           +
+       0   +
+++++++++++++
#goal
+++++++++++++
+          0+
+        ++++
+           +
+           +
+           +
+++++++++++++
#end
