#domain
hospital
#levelname
MAPF03
#colors
blue: 0, B
red: 1, A
#initial
+++++++++++++
+     0     +
+        ++++
+           +
+     A  ++ +
+    B1   + +
+++++++++++++
#goal
+++++++++++++
+A          +
+        ++++
+           +
+        ++ +
+B        + +
+++++++++++++
#end
