#domain
hospital
#levelname
MAPF03
#colors
blue: 0, B
red: A
#initial
+++++++++++++
+           +
+        ++++
+       A   +
+       B   +
+       0   +
+++++++++++++
#goal
+++++++++++++
+       B   +
+        ++++
+           +
+           +
+           +
+++++++++++++
#end
