#domain
hospital
#levelname
MAPF01
#colors
blue: 0,1,2
#initial
+++++++++++++
+          1+
+        ++++
+ 0         +
+        ++ +
+         + +
+++++++++++++
#goal
+++++++++++++
+           +
+        ++++
+           +
+        ++ +
+1        +0+
+++++++++++++
#end
