#domain
hospital
#levelname
BigPoppa
#colors
blue: 0, A
green: 1, B
#initial
+++++++++++++++++++++++++++
+                        0+
+                         +
+ +++++++++++++++++++++++A+
+                        1+
+++++++++++++++++++++++++++
#goal
+++++++++++++++++++++++++++
+                        1+
+                         +
+ +++++++++++++++++++++++ +
+                         +
+++++++++++++++++++++++++++
#end
