#domain
hospital
#levelname
MAthomasAppartment
#colors
red: 0, A, B, C
purple: 1, M, N, O
#initial
                   +++++++++
                   +       +
++++++++++++++++++++       +
+   C  +     +     +       +
+ A    +     +     +       +
+      +     +   1 +       +
+   B  +     +     +       +
+                  +       +
+++++++++O+ +++++++++  +++ +
+        N+             +  +
+        M+             +  +
+                   0   +  +
+                       +  +
+         +             +  +
+         +             +  +
+         +             +  +
++++++++++++++++++++++++++++
#goal
                   +++++++++
                   +       +
++++++++++++++++++++       +
+      +     +MNO  +       +
+      +     +     +       +
+      +     +     +       +
+      +     +     +       +
+                  +       +
+++++++++ + +++++++++  +++ +
+         +             +  +
+         +             +  +
+                       +  +
+                       +  +
+         +             +C +
+         +             +B +
+         +             +A +
++++++++++++++++++++++++++++
#end
